1 1 1 1 1 1 1 1 1 1 1 1 1 1 1 1 1 1 1 1 1 1 1 1 1 1 1 1 1 1 1 1
1 1 1 1 1 1 1 1 1 1 1 1 1 1 1 1 1 1 1 1 1 1 1 1 1 1 1 1 1 1 1 1
1 1 1 1 1 1 1 1 1 1 1 1 1 1 1 1 1 1 1 1 1 1 1 1 1 1 1 1 1 1 1 1
1 1 3 2 1 1 1 7 0 0 0 0 6 0 0 0 1 0 0 0 0 0 0 0 0 0 0 0 0 6 5 1
1 1 0 0 1 1 1 1 1 1 1 0 0 1 0 0 1 0 0 1 1 1 1 0 0 1 0 0 1 1 1 1
1 1 0 6 5 0 4 6 6 6 6 6 6 1 0 0 1 0 0 0 0 0 1 0 0 1 0 0 0 0 0 1
1 1 0 5 1 1 1 6 6 0 1 0 4 1 0 0 1 0 0 1 0 0 1 0 0 1 1 1 1 0 0 1
1 1 0 0 0 0 0 1 6 0 1 0 0 1 0 0 0 0 0 1 0 7 1 0 0 1 5 0 0 0 0 1
1 1 1 1 1 0 0 1 0 0 1 1 0 1 0 0 1 1 1 1 1 1 1 0 0 1 1 1 1 6 6 1
1 1 4 0 6 0 0 1 0 7 1 1 0 6 0 0 0 0 0 1 0 0 0 0 7 1 4 0 0 6 6 1
1 1 0 0 1 0 0 1 1 1 1 1 1 1 1 1 1 0 0 1 7 1 1 1 1 1 1 1 1 0 0 1
1 1 0 0 0 0 0 0 6 1 1 1 1 1 5 0 0 0 0 1 0 0 0 0 0 0 0 0 1 4 0 1
1 1 0 0 1 1 1 1 0 5 1 1 1 1 1 1 1 0 0 1 1 1 1 1 1 1 0 0 1 1 1 1
1 1 0 7 0 0 0 0 0 0 0 0 0 6 6 6 0 0 0 0 0 0 0 4 0 0 0 0 6 0 0 1
1 1 1 1 1 1 1 1 1 1 1 0 0 1 0 0 1 1 1 1 1 1 1 1 1 1 1 1 1 0 0 1
1 1 0 0 0 0 0 6 0 0 0 0 0 1 0 0 0 0 0 6 5 1 4 0 0 1 0 0 1 0 0 1
1 1 0 0 1 1 1 1 1 1 1 0 0 1 1 1 1 0 0 1 1 1 1 0 0 1 0 5 1 0 0 1
1 1 0 0 0 0 7 1 0 0 0 0 0 0 0 0 1 4 0 1 0 0 0 0 0 1 0 0 0 6 6 1
1 1 0 0 1 1 1 1 1 1 1 0 0 1 0 0 1 0 0 1 0 0 1 1 1 1 0 1 1 0 0 1
1 1 0 0 0 0 4 1 0 0 0 0 0 1 0 0 1 0 0 1 0 0 0 0 0 0 0 0 0 0 0 1
1 1 0 0 1 1 6 1 0 0 1 1 1 1 0 0 1 1 1 1 1 1 1 1 1 1 1 0 1 1 1 1
1 1 0 0 0 0 0 6 0 0 1 4 0 0 0 0 0 0 0 7 0 0 1 7 0 0 0 4 0 0 0 1
1 1 1 1 1 1 1 1 1 1 1 1 1 1 1 1 1 1 1 1 1 1 1 1 1 1 1 1 1 1 1 1