1 1 1 1
1 2 3 1
1 4 5 1
1 6 7 1
1 1 1 1